,disk write,,,,Page Fault ,Interrupt
10,49605,,,,99277,99267
20,49341,,,,98782,98762
30,48312,,,,96754,96724
40,45208,,,,90473,90433
50,44353,,,,88844,88794
60,43822,,,,87701,87641
70,43149,,,,86465,86395
80,42190,,,,84479,84399
90,41546,,,,83146,83056
100,39793,,,,79676,79576
