,disk write,,,Page Fault ,Interrupt
10,43153,,,86007,85997
20,31162,,,62019,61999
30,23178,,,46029,45999
40,10989,,,22046,22006
50,2579,,,5295,5245
60,998,,,2059,1999
70,994,,,2069,1999
80,987,,,2079,1999
90,982,,,2089,1999
100,976,,,2098,1998
