,disk write,,,Page Fault ,Interrupt
10,49295,,,98653,98643
20,48191,,,96527,96507
30,47711,,,95558,95528
40,46141,,,92486,92446
50,45055,,,90391,90341
60,44065,,,88393,88333
70,42488,,,85304,85234
80,41326,,,82975,82895
90,39773,,,79918,79828
100,38617,,,77623,77523
