,disk write,,,Page Fault ,Interrupt
10,48769,,,97964,97954
20,47785,,,96030,96010
30,46808,,,94060,94030
40,45790,,,92103,92063
50,44677,,,89903,89853
60,43728,,,88048,87988
70,42753,,,86082,86012
80,41659,,,83974,83894
90,40747,,,82121,82031
100,39571,,,80000,79900
