,disk write,,,Page Fault ,Interrupt
10,50865,,,98001,97991
20,49875,,,96084,96064
30,48820,,,94031,94001
40,47777,,,92090,92050
50,46746,,,90110,90060
60,45667,,,88016,87956
70,44687,,,86155,86085
80,43578,,,84113,84033
90,42551,,,82144,82054
100,41425,,,80022,79922
