,disk write,,,Page Fault ,Interrupt
10,49051,,,98004,97994
20,48126,,,96086,96066
30,47154,,,94087,94057
40,46146,,,92052,92012
50,45149,,,90028,89978
60,44156,,,88054,87994
70,43163,,,86039,85969
80,42202,,,84058,83978
90,41180,,,82053,81963
100,40161,,,80025,79925
