,disk write,,,Page Fault ,Interrupt
10,49963,,,100000,99990
20,49960,,,100000,99980
30,49955,,,100000,99970
40,49952,,,100000,99960
50,1002,,,2049,1999
60,1002,,,2059,1999
70,1002,,,2069,1999
80,1002,,,2079,1999
90,1002,,,2089,1999
100,1002,,,2098,1998
