,disk write,,,Page Fault ,Interrupt
10,48474,,,85051,85041
20,41593,,,73020,73000
30,36444,,,64027,63997
40,15014,,,26529,26489
50,1021,,,2049,1999
60,1021,,,2059,1999
70,1021,,,2069,1999
80,1021,,,2079,1999
90,1021,,,2089,1999
100,1020,,,2098,1998
